00000000000000000000000000000000000p000000000o00000000o000000000000000p00000000000000000000000000000000000000000000000000000000000000000000000000000000000000000|000000000000$%%%%%%%%00
00000000000000000000000000000000gggggggggggg+;ggggggggggggggggggggggggggggggggggggg00000000000000000000000000000000000000000000000000000000000000000000000000000:000000000000$%%%%%%%%00
0000$%%%%%%^00000000000000000000&22222222222222222222222222222222222222222222222222*0000000000000000000000000000000000000000000000000000000000000000000000000000:000000000000$%%%%%%%%00
0000$%%%%%%^0000000000000000000&5555555!@@@@@@@#5555555557555555555555!@@@@@@#555555*00000000000000000000000000000000000000000000000000000000000000000000000|||0:000000000000$%%%%%%%%00
0000$%%%%%%^000000000000000000&555555555$%%%%%%^55555555577755555555555$%%%%^55555555*0000000000000000000000000000000000000000000000000000000000000000000000+:;0:000000000000$%%%%%%%%00
0000$%%%%%%^00000000000000000&555555555555$%%^55555555555777555555555555$%%^5555555555*000000000000000000000000000000000000000000000000000000000000000000000+:;|||00000000000$%%%%%%%%00
0000$%%%%%%^0000000000000000&55555555555555$^555555555558877555555555555555555555555555*00000000000000000000000000000000000000000000000000000000000000000000+:;::;00000000000$%%%%%%%%00
0000$%%%%%%^000000000000000&555555555555555$^5555555558888775555555555555555555555555555*0000000000000000000000000000000000000000000000000000000000000000000+:;::;00000000000$%%%%%%%%00
0000$%%%%%%^00000000000000&5555555555555555$^55555599988887755555555555555555555555555555*00000000000000000000000000000000000000000000000000000000000000o000+:;::;000p0000000$%%%%%%%%00
0000$%%%%%%^000000000000000000000000000000000000000000000000000000000000000000000000000000000000000000000000000000000000000000000000000000000000000000gggggg+:;::;ggggggggggg$%%%%%%%%00
0000$%%%%%%^00000000000000000000000000000000000000000000000000000000000000000000000000000000000000p00000000000000000000000000000000000000000000000000&222222222222222222222223%%%%%%%%00
0000$%%%%%%^0000000000000000000000000000000000000000000000000000000000000000000000000000000000fffffffffff0000000000000000000000000000000000000000000&5555555555555555555555556%%%%%%%%00
0000$%%%%%%^0000000000000000000000000000000000000000000000000000000000000000000000000000000000!@@@@@@@@@@0000000000000000000000000000000000000o0000&55555555555555555555555556%%%%%%%%00
0000$%%%%%%^0000000000000000000000000000000000000000000000000000000000000000000000000o0000000098$%%%%%%%^00000000000000000000000000000000000ggggg0&555555555555555555555555556%%%%%%%%00
0000$%%%%%%^00000000000000000000000000000000000000000000000000000000000000000000fffffffffffff9987$%%%%%^00000000000000000000000000000000000&22222!@@@#56000000000000000000000$%%%%%%%%00
0000$%%%%%%^00000000000000000000000000000000000000000000000000000000000000000000!@@@@@@@@@@@@#8877$%%%^00000000000000000000000000000000000&5555555$%^556000000000000000000000$%%%%%%%%00
0000$%%%%%%^000000000000000000000000000000000000000000000000000000000000000000000$%%%%%%%%%%^~||||||-000000000000000000000000000000000000&555577555%5556000000000000000000000$%%%%%%%%00
0000$%%%%%%^0000000000000000000000000000000000000000000000000000000000000o00000000$%%%%%%%%%^+:::::;000000000000000000000000000000000000&555757755555556000000000000000000000$%%%%%%%%00
0000$%%%%%%^000000000000000000000000000000000000000000000000000000000gggggggggg0000000%%%%%^+:::::;000000000000000000000000000000000000&5577777746000000000000000000000000000$%%%%%%%%00
0000$%%%%%%^00000000000000000000000000000000000000000000000000000000&2222222222*00000000000000000000000000000000000000000000000000000000~|||||-000000000000000000000000000000$%%%%%%%%00
0000$%%%%%%^0000000000000000000000000000000000000000000000000000000&555555557775*0000000000000000000000000000000000000000000p000000000000+:::;0000000000000000000000000000000$%%%%%%%%00
0000$%%%%%%^000000000000000000000000000000000ggggg0000000000000000&55555555788885*000000000000000000000000o000000000000000fffffffffffff00+::;00000000000000000000000000000000$%%%%%%%%00
0000$%%%%%%^00000000000000000000000000000000&22222000000000000000&5555555558855555*00000000000000000000ggggggggg0000000000!@@@@@@@@@@@7gg+:;gggg00000000000000000000000000000$%%%%%%%%00
0000$%%%%%%^0000000000000000000000000000000&55555600000000000000&555!@@@@@#88555555*00000p000000000000&222222222*0000000000$%%%%%%%%%771222222220000000p000000000000000000000$%%%%%%%%00
0000$%%%%%%^0000000000000000000o000000p000&5555556000000o000000&5555$%%%%%^555555555*gggggggggggg0000&55555555555*gggggg000$%%%%%%%%7774555555600000ffffffff00000000000000000$%%%%%%%%00
0000$%%%%%%^00000000000000000gggggggggggg&77555556000ggggggggg&555555$%%%^5555555555!@@#222222222000045555555555!@@#2222*000$%%%%%%%%884555556000000!@@@@@@#00000000000000000$%%%%%%%%00
0000$%%%%%%^00000000000000000122222222222577760000000122222222!@@@#555$%^555555555555$%^555557556000045555555555$%^555555*00000000000000000000000000$%%%%%%%00000000000000000$%%%%%%%%00
0000$%%%%%%^000p000000o0000000455555555557755000000004555885555$%%^5555555555555555555$^5555577960000000000005555555555555*000000000000000000000000000$%%^00000000o00000p0000$%%%%%%%%00
0000$%%%%%%^ffffffffffffff000000045555!@@@#56000000004555888555$%%^5555555555555555555$^555555960000000000000000000000000000000000000000000000000000000$^000000gggggggggggggg$%%%%%%%%00
0000$%%%%%%^!@@@@@@@@@@@@#000000000455$%%%^600000000045588888555$^55555555555555555555$^5555556000000000000000000000000000000000000000~-0000000000000000000000&22222222222223$%%%%%%%%00
0000$%%%%%%%%%%%%%8888%%%^0000000000455$%^5600000000000000000000000000000000000000000000000000000000000000000000000000000000fffffff000+;0~-000000000000000000&555555555555556$%%%%%%%%00
0000$%%%%%%%%%%888%88%%%%^0000000000000000000000000000000000000000~||||||||-000000000000000000000000000000000000000000000000!@@@@@@000+;0+;00000000000000000&5555555555555556$%%%%%%%%00
0000$%%%%%%%%%%%%9%%8%%%%^000gggggg00000000000000000000000000000000<::::::/00000000000000000000000000000000000000000000000000$%%%%^00~||-:;0000000000000000&55555555555555556$%%%%%%%%00
0000$%%%%%%^$%%%%9%%8%%%%^000122223000000000000000000000000000000000<::::/0000000000000000000000000000000000000000000000000000$%%^000+::;:;000000000000000&555555555555555556$%%%%%%%%00
0000$%%%%%%^000000000000000008555600000000000000000000000000000000000<::/0000000000000000000000000000gggggggggggggggggggggg0000000000+::;:;00000000000000&5555555555555555556$%%%%%%%%00
0000$%%%%%%^0000000000000000078990000000000000000000000000000000000000+;0000000000000000000000000000&2222222222222222222222*000000000+::;:;0000000000000&55555555555555555556$%%%%%%%%00
0000$%%%%%%^00000000000000000000000000ggggggggg00000000000000000000000+;000000000000000000000000000&555555555555555555555555*00000000+::;:;000000000000&555555555555555555556$%%%%%%%%00
0000$%%%%%%^0000000000000000000000000012222222300000000000000000000000+;00000000000000000000000000&55555555555555555555555555*ggggggg+::;::ggggggggggg&5555555555555555555556$%%%%%%%%00
0000$%%%%%%^0000000000000000000000000004579956000000000000000000000000+;0000000000000000000000000&555555555555555555555555555522222222222222222222222255555555555555555555556$%%%%%%%%00
0000$%%%%%%^0000p000000000000p0000000000458860000000000o00000000000000+;0000000000p0000000000000&555555555555555555555555555555555555555555555555555555555555500000000000000000000000000
0000$%%%%%%^ggggggggggggggggggggggggggggg558gggggggggggggggggggggggggg+;ggggggggggggggggggggggg&5555555555555555555555555555555555555555555555555555555555555500000000000000000000000000
0000$%%%%%%12222222222222222222222222222255522222222222222222222222222222222222222222222222222255555555555555555555555555555555555555555555555555555555555555500000000000000000000000000
0000$%%%%%%45555555555555555555555555555555555555555555555555555555555555555555555555555555555555555555500000000000000000000000000000000000000000000000000000000000000000000000000000000
0000$%%%%%%45555555555555555555555555555555555555555555555555555555555555555555555555555555555555555555500000000000000000000000000000000000000000000000000000000000000000000000000000000
0000$%%%%%%45555555555555555555555555555555555555555555555555555555555555555555555555555555555555555555500000000000000000000000000000000000000000000000000000000000000000000000000000000
0000$%%%%%%45555555555555555555555555555555555555555555555555555555555555555555555555555555555555555555500000000000000000000000000000000000000000000000000000000000000000000000000000000
0000000000000000000000000000000000000000000000000000000000000000000000000000000000000000000000000000000000000000000000000000000000000000000000000000000000000000000000000000000000000000
0000000000000000000000000000000000000000000000000000000000000000000000000000000000000000000000000000000000000000000000000000000000000000000000000000000000000000000000000000000000000000