00000000000000000000000000000000000000000000000000000000000000000000000000000000000000000000000000000000000$%%%%%
00000000000000000000000000000000000000000000000000000000000000000000000000000000000000000000000000000000000$%%%%%
00000000000000000000000000000000000000000000000000000000000000000000000000000000000000000000000000000000000$%%%%%
00000000000000000000000000000000000000000000000000000000000000000000000000000000000000000000000000000000000$%%%%%
00000000000000000000000000000000000000000000000000000000000000000000000000000000000000000000000000000000000$%%%%%
00000000000000000000000000000000000000000000000000000000000000000000000000000000000000000000000000000000000$%%%%%
00000000000000000000000000000000000000000000000000000000000000000000000000000000000000000000000000000000000$%%%%%
00000000000000000000000000000000000000000000000000000000000000000000000000000000000000000000000000000000000$%%%%%
0000$%%%%%%^00000000000000000000000000000000000000000000000000000000000000000000000000000000000000000000000$%%%%%
0000$%%%%%%^00000000000000000000000000000000000000000000000000000000000000000000000000000000000000p00000000$%%%%%
0000$%%%%%%^0000000000000000000000000000000000000000000000000000000000000000000000000000000000fffffffffff00$%%%%%
0000$%%%%%%^0000000000000000000000000000000000000000000000000000000000000000000000000000000000!@@@@@@@@@@00$%%%%%
0000$%%%%%%^0000000000000000000000000000000000000000000000000000000000000000000000000o00r0000098$%%%%%%%^00$%%%%%
0000$%%%%%%^00000000000000000000000000000000000000000000000000000000000000000000fffffffffffff9987$%%%%%^000$%%%%%
0000$%%%%%%^00000000000000000000000000000000000000000000000000000000000000000000!@@@@@@@@@@@@#8877$%%%^0000$%%%%%
0000$%%%%%%^000000000000000000000000000000000000000000000000000000000000000000000$%%%%%%%%%%^~||||||-000000$%%%%%
0000$%%%%%%^0000000000000000000000000000000000000000000000000000000000000000000000$%%%%%%%%%^+:::::;0000000$%%%%%
0000$%%%%%%^00000000000000000000000000000000000000000000000000000000000000000000000000%%%%%^+:::::;00000000$%%%%%
0000$%%%%%%^00000000000000000000000000000000000000000000000000000000&2222222222*000000000000000000000000000$%%%%%
0000$%%%%%%^0000000000000000000000000000000000000000000000000000000&555555557775*00000000000000000000000000$%%%%%
0000$%%%%%%^000000000000000000000000000000000000000000000000000000&55555555788885*0000000000000000000000000$%%%%%
0000$%%%%%%^00000000000000000000000000000000&22222000000000000000&5555555558855555*000000000000000000000000$%%%%%
0000$%%%%%%^0000000000000000000000000000000&55555600000000000000&555!@@@@@#88555555*00000000000000000000000$%%%%%
0000$%%%%%%^000000000000000000000000000000&55555560000000000000&5555$%%%%%^555555555*0000000000000000000000$%%%%%
0000$%%%%%%^000000000000000000000000a0000&77555556000000000000&555555$%%%^5555555555!@@#222222223000000&223$%%%%%
0000$%%%%%%^00000000000000000122222222222577760000000122222222!@@@#555$%^555555555555$%^55555755600000&5556$%%%%%
0000$%%%%%%^00p000000o00000000455555555557755000000004555885555$%%^5555555555555555555$^5555577960000&55556$%%%%%
0000$%%%%%%^ffffffffffffff000000045555!@@@#56000000004555888555$%%^5555555555555555555$^5555559600000004556$%%%%%
0000$%%%%%%^!@@@@@@@@@@@@#000000000455$%%%^600000000045588888555$^55555555555555555555$^5555556000000000456$%%%%%
0000$%%%%%%%%%%%%%8888%%%^0000000000455$%^56000000000000000000000000000000000000000000000000000000000000456$%%%%%
0000$%%%%%%%%%%888%88%%%%^0000000000000000000000000000000000000000~||||||||-000000000000000000000!@@@#00456$%%%%%
0000$%%%%%%%%%%%%9%%8%%%%^00000000000000000000000000000000000000000<::::::/0000000000000000000000$%%^000456$%%%%%
0000$%%%%%%^$%%%%9%%8%%%%^000122223000000000000000000000000000000000<::::/00000000000000000000000$%00000456$%%%%%
0000$%%%%%%^000000000000000008555600000000000000000000000000000000000<::/0000000000000000000000000000000456$%%%%%
0000$%%%%%%^0000000000000000078990000000000000000000000000000000o00000+;0000000000000000000000000000&222223$%%%%%
0000$%%%%%%^0000000000000000000000000000000000000000000000p000ffffffff+;000000000000000000000000000&5555556$%%%%%
0000$%%%%%%^000000000000000000000000001222222230000000ffffffff7!@@@@@@@@#0000000000000000000000000&55555556$%%%%%
0000$%%%%%%^000000000000000000000000000457995600000000!@@@@@@78%%%%%%%%%^000000000000000000000000&555555556$%%%%%
0000$%%%%%%^0000000000000000000000000000458860000000000$%%%%78%%%%%%%%%%^00000000000000000000000&5555555556000000
0000$%%%%%%^000000000s0000000000000000000558000000000000$%%%%%%%%%%%%%%^00000000000000000000000&55555555556000000
0000$%%%%%%1222222222222222222222222222225552222222*00000000000000000000000&2222222222222222222555555555550000000
0000$%%%%%%45555555555555555555555555555555555555555*000000000000000000000&55555555555555555555555555555000000000
0000$%%%%%%455555555555555555555555555555555555555555*0000000000000000000&555555555555555555555555555555000000000
0000$%%%%%%4555555555555555555555555555555555555555555*00000000000000000&5555555555555555555555555555555000000000
0000$%%%%%%45555555555555555555555555555555555555555555*000000000000000&55555555555555555555555555555555000000000
00000000000000000000000000000000000000000000000055555555222222222222222555555550000000000000000000000000000000000
00000000000000000000000000000000000000000000000055555555555555555555555555555500000000000000000000000000000000000
00000000000000000000000000000000000000000000000055555555555555555555555555555500000000000000000000000000000000000